#map
333333333333333333333333333333333333333333333333333333333333333333333333333333333333333333
333333333333333333333333333333333333333333333333333333333333333333333333333333333333333333
333333333333333333333333333333333333333333333333333333333333333333333333333333333333333333
333333333333333333333333333333333333333333333333333333333333333333333333333333333333333333
333333333333333333333333333333333333333333333333333333333333333333333333333333333333333333
333333333333333333333333333333333333333333333333333333333333333333333333333333333333333333
333333333333333333333333333333333333333333333333333333333333333333333333333333333333333333
333333333333333333333333333333333333333333333333333333333333333333333333333333333333333333
333333333333333333333333333333333333333333333333333333333333333333333333333333333333333333
333333333333333333333333333333333333333333333333333333333333333333333333333333333333333333
333333333333333333333333333333333333333333333333333333333333333333333333333333333333333333
333333333333333333333333333333333333333333333333333333333333333333333333333333333333333333
333333333333333333333333333333333333333333333333333333333333333333333333333333333333333333
333333333333333333333333333333333333333333333333333333333333333333333333333333333333333333
333333333333333333333333333333333333333333333333333333333333333333333333333333333333333333
333333333333333333333333333333333333333333333333333333333333333333333333333333333333333333
333333333333333333333333333333333333333333333333333333333333333333333333333333333333333333
333333333333333333333333333333333333333333333333333333333333333333333333333333333333333333
333333333333333333333333333333333333333333333333333333333333333333333333333333333333333333
333333333333333333333333333333333333333333333333333333333333333333333333333333333333333333
333333333333333333333333333333333333333333333333333333333333333333333333333333333333333333
333333333333333333333333333333333333333333333333333333333333333333333333333333333333333333
333333333333333333333333333333333333333333333333333333333333333333333333333333333333333333
333333333333333333333333333333333333333333333333333333333333333333333333333333333333333333
333333333333333333333333333333333333333333333333333333333333333333333333333333333333333333
333333333333333333333333333333333333333333333333333333333333333333333333333333333333333333
333333333333333333333333333333333333333333333333333333333333333333333333333333333333333333
333333333333333333333333333333333333333333333333333333333333333333333333333333333333333333
333333333333333333333333333333333333333333333333333333333333333333333333333333333333333333
333333333333333333333333333333333333333333333333333333333333333333333333333333333333333333
333333333333333333333333333333333333333333333333333333333333333333333333333333333333333333
333333333333333333333333333333333333333333333333333333333333333333333333333333333333333333
333333333333333333333333333333333333333333333333333333333333333333333333333333333333333333
333333333333333333333333333333333333333333333333333333333333333333333333333333333333333333
333333333333333333333333333333333333333333333333333333333333333333333333333333333333333333
333333333333333333333333333333333333333333333333333333333333333333333333333333333333333333
333333333333333333333333333333333333333333333333333333333333333333333333333333333333333333
333333333333333333333333333333333333333333333333333333333333333333333333333333333333333333
333333333333333333333333333333333333333333333333333333333333333333333333333333333333333333
333333333333333333333333333333333333333333333333333333333333333333333333333333333333333333
333333333333333333333333333333333333333333333333333333333333333333333333333333333333333333
333333333333333333333333333333333333333333333333333333333333333333333333333333333333333333
333333333333333333333333333333333333333333333333333333333333333333333333333333333333333333
333333333333333333333333333333333333333333333333333333333333333333333333333333333333333333
333333333333333333333333333333333333333333333333333333333333333333333333333333333333333333
333333333333333333333333333333333333333333333333333333333333333333333333333333333333333333
333333333333333333333333333333333333333333333333333333333333333333333333333333333333333333
333333333333333333333333333333333333333333333333333333333333333333333333333333333333333333
333333333333333333333333333333333333333333333333333333333333333333333333333333333333333333
333333333333333333333333333333333333333333333333333333333333333333333333333333333333333333
DDDDDDDDDDDDDDDDDDDDDDDDDDDDDDDDDDDDDDDDDDDDDDDDDDDDDDDDDDDD66666DDDDDDDDD3333333333333333
DDDDDDDDDDDDDDDDDDDDDDDDDDDDDDDDDDDDDDDDDDDDDDDDDDDDDDDDDDDD66666DDDDDDDDD3333333333333333
DDDDDDDDDDDDDDDDDDDDDDDDDDDDDDDDDDDDDDDDDDDDDDDDDDDDDDDDDDDD66666DDDDDDDDD3333333333333333
DDDDDDDDDDDDDDDDDDDDDDDDDDDDDDDDDDDDDDDDDDDDDDDDDDDDDDDDDDDD66666DDDDDDDDD3333333333333333
DDDDDDDDDDDDDDDDDDDDDDDDDDDDDDDDDDDDDDDDDDDDDDDDDDDDDDDDDDDD66666DDDDDDDDD3333333333333333
DDDDDDDDDDDDDDDDDDDDDDDDDDDDDDDDDDDDDDDDDDDDDDDDDDDDDDDDDDDD66666DDDDDDDDD3333333333333333
DDDDDDDDDDDDDDDDDDDDDDDDDDDDDDDDDDDDDDDDDDDDDDDDDDDDDDDDDDDD66666DDDDDDDDD3333333333333333
DDDDDDDDDDDDDDDDDDDDDDDDDDDDDDDDDDDDDDDDDDDDDDDDDDDDDDDDDDDD66666DDDDDDDDD3333333333333333
DDDDDDDDDDDDDDDDDDDDDDDDDDDDDDDDDDDDDDDDDDDDDDDDDDDDDDDDDDDD66666DDDDDDDDD3333333333333333
DDDDDDDDDDDDD???????????????????????????@?????@8888888888888?CCC?@DDDDDDDD3333333333333333
DDDDDDDDDDDDD@3B3B3B3B3B3B3@============@B3B3B@D8:::::55555866666@DDDDDDDD3333333333333333
DDDDDDDDDDDDD@B3@@@@B3B3B3B@=AA===AA=AA=@3B3B3@D8:::::55555566666@DDDDDDDD3333333333333333
DDDDDDDDDDDDD@3B@DD@3B@@3B3@============@B3B3B@D8:::::55555566666@DDDDDDDD3333333333333333
DDDDDDDDDDDDD@B3@@@@B3@@B3B@=AA===AA=AA=@3B3B3@D85555555555866666@DDDDDDDD3333333333333333
DDDDDDDDDDDDD@3B3B3B3B@@3B3@============@B3B3B@D85555558888866666@DDDDDDDD3333333333333333
DDDDDDDDDDDDD@B?????????B3B@=AA======AA=@3B3B3@D8555555866666666@@DDDDDDDD3333333333333333
44444444444444344444444??B??????4=4?????@B3B3B@D8555555866666666@@DDDDDDDD3333333333333333
@444444@?????@B@444444@3B3B3B3B3B3B3CCCC@3B3B3@D8555555866666666@@DDDDDDDD3333333333333333
@=DDDD=@77787@3@=:<<:=@B3B3B3B3B3B3B3B3B@B3B3B@D8555555866666666@@DDDDDDDD3333333333333333
@=DDDD=@77777@B@=:<<:=@;;;;3B3B3B3B3B3B3B3B3B3@D8555555866666666@@DDDDDDDD3333333333333333
@=DDDD=@77788@3@=:<<:=@CCCCB3B3B3B3B3B3B3B3B3B@D8:::555866666666@@DDDDDDDD3333333333333333
@=D::D=@77777@B@=:<<:=@;;;;3B3B3B3B3B3B3B3B3B3@D8:::555866666666@@DDDDDDDD3333333333333333
@=:77:=@??7??@3?=:<<:=@B3B3B3B3B3B3B3B3B@B3B3B@D8:::555866666666@@DDDDDDDD3333333333333333
@=::::=4B3B3B3B4=::::=@CCCC3BCCCCCB3CCCC@3B3B3@D8:::5558888866666@DDDDDDDD3333333333333333
@=:<<:=B3B3B3B3B=:77:=@?????????????????@B3B3B@D8:::5555555866666@DDDDDDDD3333333333333333
@=:<<:=3B3B3B3B3=D::D=@3B3B3B3B3B3B3B3B3B3B3B3@D855555:::55866666@DDDDDDDD3333333333333333
@=:<<<=43B3B3B34=DDDD=@B3B3B3B3B3B3B3B3B3B3B3B@D855555:::55866666@DDDDDDDD3333333333333333
@=:<<<=4B3B3B3B4=DDDD=@3B3B3B3B3B3B3B3B3B3B3B3@D855555:::55@66666@DDDDDDDD3333333333333333
@=:<<:=43B3B3B34=DDDD=@B3B3B3B3B3B3B3B3B3B3B3B@D855555:::55@66666@DDDDDDDD3333333333333333
@=:<<:=4B3B3B3B4=DDDD=@3B3B3B3B3B3B3B3B3B3B3B3@D855555:::55@66666@DDDDDDDD3333333333333333
@=:<<:=43B3B3B34=DDDD=@???????????????????????@D85555555555866666@DDDDDDDD3333333333333333
@=:<<:=4B3B3B3B4=DDDD=@DDDDDDDDDDDDDDDDDDDDDDD@D85555555555866666@DDDDDDDD3333333333333333
@=:<<:=43B3B3B34=DDDD=@DDDDDDDDDDDDDDDDDDDDDDD@D85555555555866666@DDDDDDDD3333333333333333
@=:<<:=4B3B3B3B4=DDDD=@DDDDDDDDDDDDDDDDDDDDDDD@D85555555555866666@DDDDDDDD3333333333333333
@4444444???B???4444444??????????????????????????85558888888866666@DDDDDDDD3333333333333333
4DDDDDDDDDDDDDDDDDDDDDDDDDDDDDDDDDDDDDDDDDDDDDD@85558666666666666@DDDDDDDD3333333333333333
4DDDDDDDDDDDDDDDDDDDDDDDDDDDDDDDDDDDDDDDDDDDDDDD55558666666666666@DDDDDDDD3333333333333333
4DD3CCC3ADDDDDDDDDDDDDDDDDDDDDDDDDDDDDDDDDDDDDDD55558666666666666@DDDDDDDD3333333333333333
4DDCC77CCDDDDDDDDDDDDDDDDDDDDDDDDDDDDDDDDDDDDDDD55558666666666666@DDDDDDDD3333333333333333
4DD3CCC3ADDDDDDDDDDDDDDDDDDDDDDDDDDDDDDDDDDDDDD@85558666666666666@DDDDDDDD3333333333333333
????????????????????????????????????????????????88888?????????????DDDDDDDD3333333333333333
#objects
player,372.43115,82.185776
item,371.31653,114.65368,MP5,25
decoration,352.0,192.0,box,2
bot,352.0,320.0,0.0,400.0,2,Beretta,64
decoration,320.0,576.0,box,1
item,256.0,672.0,Medkit,0
item,256.0,704.0,Medkit,0
bot,288.1521,699.3052,0.0,400.0,2,Shotgun,64
item,352.0,672.0,AK47,33
item,524.0061,266.3535,Grenade,5
bot,128.0,448.0,0.0,400.0,3,AK47,64
bot,125.790344,415.61752,0.0,400.0,2,AK47,64
bot,781.8828,829.98334,0.0,400.0,2,Colt,64
item,832.0,800.0,MP5,20
bot,896.0,640.0,0.0,400.0,3,MP5,64
bot,1056.0,640.0,0.0,400.0,1,MP5,64
bot,1056.0,896.0,0.0,400.0,1,Shotgun,64
bot,1376.0,960.0,0.0,400.0,3,Sniper,64
bot,1408.0,800.0,0.0,400.0,1,MP5,64
bot,736.0,416.0,0.0,400.0,1,Beretta,0
decoration,736.0,352.0,bed,30
decoration,736.0,448.0,bed,30
item,672.0,864.0,Energy,0
item,743.09076,415.92902,Colt,1
decoration,1248.0,448.0,bed,81
decoration,1248.0,352.0,bed,90
decoration,1120.0,384.0,bed,56
decoration,1120.0,448.0,bed,80
bot,928.0,448.0,0.0,400.0,1,AK47,114
bot,928.0,480.0,0.0,400.0,2,Shotgun,87
bot,928.0,416.0,0.0,400.0,1,MP5,96
bot,928.0,384.0,0.0,400.0,1,Colt,145
item,1126.9465,824.28656,Shotgun,22
nextlevel,1748.4838,35.47553,89.93274,154.23245
item,1696.0,96.0,Bazooka,0
bot,1984.0,96.0,0.0,400.0,51,Shotgun,26
decoration,1792.0,704.0,bed,30
decoration,1824.0,704.0,bed,30
decoration,1792.0,704.0,pallet,30
decoration,1792.0,672.0,ammoBox,30
decoration,1824.0,672.0,ammoBox,30
decoration,1824.0,768.0,ammoBox,30
decoration,1792.0,768.0,ammoBox,30
barrel,1824.0,576.0,1
barrel,1792.0,576.0,0
barrel,1792.0,608.0,0
barrel,1789.2003,591.1813,0
decoration,1991.9429,626.8043,deadtree,30
decoration,2003.405,665.4891,deadtree,30
decoration,2005.8215,991.0857,deadtree,30
decoration,1952.0,1024.0,ammoBox,30
decoration,1952.0,1024.0,palm1,30
decoration,1888.0,1088.0,palm1,30
decoration,2016.0,1088.0,tree2,30
decoration,1952.0,1024.0,palm1,30
decoration,1856.0,1024.0,tree1,30
decoration,2080.0,992.0,palm1,30
decoration,1984.0,672.0,tree1,30
decoration,1888.0,224.0,deadtree,30
decoration,2016.0,352.0,palm1,30
decoration,2009.0029,-15.690048,palm1,30
decoration,707.2593,110.36554,palm1,30
decoration,402.773,-8.558014,palm1,30
barrel,768.0,896.0,1
item,1152.0,800.0,Energy,0
#end
