#map
44444444444444444444
40000000000000000004
4000=============004
4000=============004
4000==00000000000004
44??55???????????444
44@5555@55555555@444
44@5555@55555555@444
44@5555@555@??55@444
44@555?@555@5555@444
44@55555555@5555@444
44@55555555@5555@444
44???????????55??444
4000000000000==00004
4000000000000==00004
4000000000000==00004
40=============00004
40=============00004
40000000000000000004
44444444444444444444
#objects
player,533.89996,527.0
nextlevel,54.350067,32.50003,100.04994,188.6
#end